11111111111111111111111111111111111111
10000000000000000000000100000000100001
10000000000000000000000100000000100001
10000000000000000000000100000000100001
10000111111111111111100100000000100001
10000000000010000000000100000000100001
10000000000010000000000100111100000001
10000000000010000000000100000100000001
10000000010010011111111100000100000001
10000000010010010000000100000100000001
10000000010010010000000100111100100001
10000000010000010010000100000000100001
10000000010000010010000100000000100001
10000000010000010010000100000000100001
10000000010000000010000100011111111111
10000000010000000010000000000000000001
10000000010000000010000000000000000001
10000000010010000010000111111111111001
10001111110010001111100000000000000001
10000000000010001000000000000000000001
10000000000010001000000111111111111001
10000000000010001000000000000000000001
10000000000010000000000000000000000001
11111111111111111111111111111111111111

